111111111111111111111111111111111
100000000011000000000000111111111
101100000111000000000000111111111
100100000000000000000000111111111
1111111110110000011100000000000001
100000000011000001110111111111111
111101111111110111000000100011111
111101111111110111010100100011111
110000001101010111000000100011111
100000000000000011000000000001111
10000000000000001101010010001
11000001110101011111011100N001
11110111 1110101 101111010001
11111111 1111111 111111111111