

NO texture/saay.xpm
SO ./texture/saay1.xpm 
WE ./texture/saay2.xpm
EA ./texture/saay3.xpm

F 98,0,55
C 000,000,33

  111 11  1 1 1 1 1 
    11111
    1111   1
1111011111111111111
    1000010000010101
11111111100010001111111111
1010000N0000100000000111001
1111111111111111000000001111111111
   111111010000110000000001111111
   10001000001111111111111111111111
   10001000001111111111111111111111
   1000100000111111111111111111111111
11111111111111111


                             1
                            101                      
                            111  11
                             