NO ./textures/saay.xpm
SO ./textures/saay1.xpm
WE ./textures/saay2.xpm
EA ./textures/saay3.xpm

C 135,206,235
F 192,192,192 

 1 1 1 1 1  1 1 1 1 1 
      111111
	11   1
111111111111111111
1000010000010100001
1111111110001000001111111111
1010000000001000000001
1111111110000000001111111111
100001100000000001
10000000000000001
100000100000000001
111111111111111111