
NO ./textures/saay.xpm
SO ./textures/saay1.xpm
EA ./textures/saay3.xpm
WE ./textures/saay2.xpm

F 192,192,192
C 135,206,235


1111111111111111111
1000010000000000001
1000000000000000001
1000000001000000001
1000000000000000001
10000110000000N0001
1000000000000000001
1000000100000000001
1111111111111111111