
NO ./textures/saay.xpm
SO ./textures/saay1.xpm
EA ./textures/saay3.xpm
WE ./textures/saay2.xpm


F 192,192,192
C 135,206,235

        11
111111111111111111
1000010000000000001
1111111110000000001111111111
     110000000001000000001
1111111110000000001111111111
100001100000000001
00000000000000001
100000100000000001
111111111111111111
