

NO ./texture/1.xpm
SO ./texture/2.xpm 
WE texture/3.xpm
EA ./texture/4.xpm

F 98,0,55
C 000,000,33

  111 11  1 1 1 1 1 
    11111
    1111   1
1111011111111111111
    1000010000010101
11111111100010001111111111
101000000000100000000111001
1111111111111111000000001111111111
   111111010000110000000001111111
   1000100000E00000000000111111111
   10001000000000000000001111111111
   100010000111111111111111111111111
1111111111111


                             1
                            101                      
                            111  11
                             