NO ./textures/saay.xpm
SO ./textures/saay1.xpm
WE ./textures/saay2.xpm
EA ./textures/saay3.xpm


F 98,0,55
C 000,000,33

  1 11 1 1  1 1 1 1 1 
    11111
    1111   1
111101111111111111
1000010000010100001
111111111000100000111111111
101000000000100000000111111
1111111111111111000000001111111111
    111111010000110000000001111111
   10001000001111111111111111111111111
   10001000001111N1111111111111111111
   10001000001111111111111111111111111
11111111111111111