


SO ./texture/drogba.xpm
EA ./texture/chelsea.xpm
NO ./texture/winners.xpm 
WE ./texture/jhon.xpm

F 000,54,52   
C 110,12,12
    
  11111
1111011111111111111
    1000010000010101
11111111100010001111111111
101000000000100000000111001
1111111111111111000000001111111111
   111111010000110000000001111111
   1000000000000000000000111111111
   1000100000000000000000111111111
   1000100000000000000001111111111
   10001000000000000000001111111111111
   1000100000000000000000111111111
   1000100000000000000000111111111
   1000100000000000000000111111111
   1000100000000000000000111111111
   1000100000000000000000111111111
   1000100000000000000000111111111
   100010000000000000000111111111
   1000100000000000000000111111111
   10001000000000000000111111111
   1000100000000000000000111111111
   1000100000000000000000111111111
   1000100000000111111000000000111111111
   1000100000S00111111000000000111111111
   10001000000001111111000000000111111111
   1000100000000000000000111111111
   1000100000000000000000111111111
   1000100000000000000000111111111
   1000100000000000000000111111111
   1000100000000000000000111111111
   1000100000000000000000111111111
   100010000000000000000111111111
   100010000000000000000111111111
   1000100000000000000000111111111
   1000100000000000000000111111111
   100010000111111111111111111111111
1111111111111111111111111111111111
          101
          111