
C 000,12,12

SO ./texture/frame_00_delay-0.02s.xpm
NO ./texture/winners.xpm 
WE ./texture/jhon.xpm
EA ./texture/chelsea.xpm

F 253,5,55

  111 11  1 1 1 1 1 
    11111
    1111   1
1111011111111111111
    1000010000010101
11111111100010001111111111
101000000000100000000111001
1111111111111111000000001111111111
   111111010000110000000001111111
   1000000000000000000000111111111
   1000100000000000000000111111111
   1000D00000000000000000111111111
   10001000000E0000000000000000000D
   1000100000000000000000111111111
   1000100000000000000000111111111
   1000100000000000000000111111111
   1000100000000000000000111111111
   1000100000000000000000111111111
   1000100000000000000000111111111
   1000100000000000000000111111111
   1000100000000000000000111111111
   1000100000000000000000111111111
   1000100000000000000000111111111
   1000100000000000000000111111111
   1000100000000000000000111111111
   1000100000000000000000111111111
   1000100000000000000000111111111
   1000100000000000000000111111111
   1000100000000000000000111111111
   1000100000000000000000111111111
   1000100000000000000000111111111
   1000100000000000000000111111111
   1000100000000000000000111111111
   1000100000000000000000111111111
   1000100000000000000000111111111
   1000100000000000000000111111111
   1000100000000000000000111111111
   100010000111111111111111111111111
1111111111111