


SO ./texture/drogba.xpm
EA ./texture/1.xpm
WE ./texture/jhon.xpm
NO ./texture/winners.xpm

C 110,12,12
F   0, 00 0,9

    1  1
  1111111
111101111111111111111
    1000010000010101N1
11111111100010001111011111
101000000000100000000111001
1111111111111111000000001111111111
1111111111111111111111111111111111
          101
          111